XXXXXXXXXXXX
X...X..X..eX
X.X....X.XXX 
X..X.X.X.X.X
XX.XXX.X...X
X........X.X
XsXX...X...X
XXXXXXXXXXXX