XXXXXXXXXXXXXXXXXXXXXX
X...X...X...XX.X..X.eX
XX....X...X......X..XX
XX...X..X.X..XXX...X.X
X..X..X.X...X...XX...X
X.XX...X.X....X.X..X.X
X.X..X...X.X.X....X.XX
XX..XX...X.X..X.X....X
XX.X..XXX..XX..X..XX.X
X..X.XX...X...XX.X...X
X.XX....X.X.X....XXX.X
X...X.XXXX..XXXXX....X
XXX...X.X..X.....X.X.X
X..XXX....X..X.X...X.X
X.X..X.XX...X...XXX..X
X.X.XX...X..XXX.....XX
X.....XX.XXX....X.X..X
XsX.X........X.....X.X
XXXXXXXXXXXXXXXXXXXXXX
