XXXXXXXXXXXXXXXXXXXX
X..X...X......XX..eX
XX.....X...XX....X.X
X......X.X.X.X.X..XX
X...XX...X...XX.X..X
X.X.....X..X.....X.X
X.XXX..X...XXXXX.X.X
X........X.....X.X.X
XsX.X.X......X..X..X
XXXXXXXXXXXXXXXXXXXX
