XXXXXXXXXXXXXXXXX
X..........X..XeX
X...XX.XX.XX.X..X
X..XXX..XX...X.XX
X...X.X....XX...X
X.X....XX.X...X.X
X.X.XX.X.XX.XXX.X
X..X........X...X
XX...XX.XXXX..X.X
X..X........X...X
XX....XXXXX...X.X
X...XXX...X.....X
X.X.....X.XX.XX.X
Xs...X.X........X
XXXXXXXXXXXXXXXXX
