XXXXXXXXXXXXXXXXXXXXXXXXXXXXXXXXXXXX
X.......X.X..X..X.X......X...X....eX
X..X.X.X.....XX....X.X.X..X.X..XX.XX
X..X..X..XXX...X.X..X..XX....X..X..X
X.X.........XX...XX...X..XX...X..X.X
X...XX.XX.X...XXX..XXX.X.X..X......X
X.XX...X...XX.....X........XXX.X.X.X
X.X.X.X..X.X.X.XX.X.X.X.XX..XX..X..X
X.X....X.XX..X...X...XX...X.....X.XX
Xs...X......X..X...X...XX....X.....X
XXXXXXXXXXXXXXXXXXXXXXXXXXXXXXXXXXXX
