XXXXXXXXXXXXXXXX
X...X.XX......eX
X.X......XX....X
X..XX.XXXX..XX.X
X.X..X.......X.X
X.X.X..XX.XX.X.X
X...X.X....X..XX
X.XX..XX.X..X..X
X..X......X.XX.X
XX.X...X.X.....X
XX..X..X..XX...X
X.X...X.X...XXXX
X..XX...XX.X...X
X..X..X..X...X.X
X....XXX..XX.X.X
XXXXXXX.X.X....X
X....X...X..X.XX
Xs.X...........X
XXXXXXXXXXXXXXXX
