XXXXXXXXXXXXXXXXXXX
X..X....XXX...X..eX
X.X..XX..X..X.X.X.X
X...XX.XXX.X..X.X.X
XX.X.......XX..XX.X
XX..X.X.XX...X.X..X
X..XX..X.......X.XX
X.X...X..XXX..X...X
X.X.XX.X.X...X....X
X.X....X.X.XX.X.X.X
X...X.X..X.XX...X.X
XX..X...XX....X...X
X...XXX.X.XX....X.X
X......X....X.X.X.X
X.XX.XX...XX..X...X
X..X.X..X....XXXX.X
X.X....XX.X.XXX...X
X.X.XXX...X..X....X
XsX.....X..X...X..X
XXXXXXXXXXXXXXXXXXX
