XXXXXXXXXXXXXXXXXXXXXXXXXXXXXXXXXXXXXXXXXX
X.....XX........X.X........X.........X..eX
X.XXX....XX.X.X.....XX.XXX.XX.XX.XXXX..X.X
X.X....X..X..X..X.X...X.......XXX...X.X..X
X.X.XXX.X.X.X..X..X.X.X.X.X.X..X..X....X.X
X....X...X..X.X..X.X..XX.X...XX..XXX.XX..X
X.X.X..X.X.XX..X...X.X....XX..X.X.X.X...XX
X..X..XX...X.X..XX.X.X.XX..XX.X.X...X.X.XX
X.XX.X..X.X....X.........X...X...X.X..X..X
XX...X.....XXX..X.X.XX.X.XX.X..X.X.X.XXX.X
X..XX....XX...X..X....XX..X..X..X..X.XX..X
XX.XX.XXX...X.X.X...X....X..X.X...XX...X.X
XX...XX...XX..X...X.XXX....X..XXX....X..XX
X..X.X..XX..X..XXX....XX.X...X...XX...X..X
X.X..X.X..X..X....X.X.......XX.X.XX.X.X.XX
X.X.X..XX...X..X.X...X.XX..X...X.....XX..X
XXX.X.X..X.X..XX...XX...XXX..XX.XXX.....XX
X...X.XX....X...X....X.X....X...X..X..X..X
X.X.X...X.X..X.X.X.X.X.X.XXXX.X.X.XXX..X.X
X.XX.X.XX..X..X...XX..X......XX.X.XX..XX.X
Xs........XXX...X...X...XX.X....X....X...X
XXXXXXXXXXXXXXXXXXXXXXXXXXXXXXXXXXXXXXXXXX
