XXXXXXXXXXXXX
X.X....X.X.eX
X....X.....XX
XX.X.X.XXX..X
X..X......X.X
X.XXXX..X...X
X..X......XXX
X...X.X.....X
X.X.......X.X
X..X........X
X.X.XX.X.XXXX
X.....X.....X
XsX.X...X.X.X
XXXXXXXXXXXXX
