XXXXXXXXXXXXX
X....X.X...eX
X.X.X....X..X
X.....X.XX..X
X..XXXXX....X
X........X..X
X.X..XX.....X
X...XX..X...X
X.X....XXXX.X
X.X..X..X...X
Xs..XXX...X.X
XXXXXXXXXXXXX
