XXXXXXXXXXXXXXXXXXXXXXXXXXXXXXXXXXXXXXXXXXX
X..XXX.......X...X.....X.......X.X...X...eX
XX..X..X.X.X..XX...XXX.X.XX.X.X..X.X.X.XX.X
X.X...X.X.X.X...X.X.....X...X...XX.X.X..X.X
X...XX.......X.X..XX.X...XX..X.X...X..X..XX
X.XX..X.X.X.XX.X.X.....X...X..XX.XX.X..X..X
X.X..X..X..X...X.X.XX...XX...X...X..X.X..XX
X..X...X..XX.XX..X.XX.X...X.X..XXX.XX..X..X
XX..X.X......X..XXX....XX.X.X.XX...X..X.X.X
X.X......XXXX.X..X..XX.XX.X.X...X.X..X....X
X...XX.X....X...X..X...X..X..XX.X...X..XX.X
X.X...XXX.X.X.XX..X..X...X.X.X..X.XX.X.X..X
X.XXX..X.X..X..X.X.X.XX.X.....X.X.X....XXXX
XX...X....X...X....X...X.XXXX..X..X.XX....X
X..X..XXX.X.X.X.XX.X.X.X.....XX.X..X...XX.X
X.X.X.....X.XX..X.X....X.XXX.....X.XX.X...X
X...X.XXX..X...X....XX......XX.X.....X..X.X
X.X..X...XX..XX..XX..XX.X.X..X.X.X.X.X.X..X
X.X.XX.X.XX.XX.X..XXX....X.X.X.XX.....X..XX
XsX....X........X.....XX..........X.X...XXX
XXXXXXXXXXXXXXXXXXXXXXXXXXXXXXXXXXXXXXXXXXX
