XXXXXXXXXXXXXXXXXXXXXXXXXXXXXXXXXXXXXXXXXXXXXX
X.X.......X......X......X.X.......X.......X.eX
X...XX.XXX..XX.X..XXXXX.....X.XX.X..X.X.X....X
X.XX.X...X.XXX.X.X.....XXX.X.X.X...X.X.X..XX.X
X....XXX....X..X...XX.X...XX....X.X.....X....X
XXXX.....X.X..X.XXX.X.X......XX.X.XXX.X.X..X.X
X...XX.X..X..X....X.....XXXXX.X..X....X..XX..X
X.X.....X..X.XXXX....X.X....X..X.X.XX..X.X..XX
X.XX..X..X.X.....X..X..X.XX..X...X.X.X.X...X.X
XX...X..X...XXXX..X.......X.XXX.X..X..X.XX.X.X
X..XX..X.XX.....X..XXXXXX.X..X...X..X...X....X
XX..X.X.....X.X..X....X...XX..XX.XX..X.XX.XX.X
X..XX.X.XX.X..X.X.XXX....X..X..X..X.X..X..X..X
XX....X.X.X..X.X..X...X...X...X.X...XX...X..XX
XX.XXXX...X.X....XX.XX.X.X...X...XXX.X.XX..X.X
X..X...XXXX...X.....X...X..X.X.X...X.....X...X
X.X..X.X...XXX...X.XX.X...X.....XXX..XXX.XXX.X
Xs..X....X.....X.X.....X.X..X.X.....X........X
XXXXXXXXXXXXXXXXXXXXXXXXXXXXXXXXXXXXXXXXXXXXXX
