XXXXXXXXXXXXXXX
XX.X....X.....X
X...X.X.X.X.X.X
X.X.XX....X.X.X
X.X...XX.X..XXX
X..XX...XXX...X
X.X..XX..X..X.X
X..X...X..XXX.X
XX.X.X.XX.....X
X..X.X...XXXX.X
XX.X.XX.X.....X
XX.X..X..X.X.XX
X..XX..X..X...X
X.X..X.XX...X.X
X..X.....XXX.XX
XX..XX.XX.....X
X.X...X...XXX.X
X...X...XXX...X
X.XX.XX.X...X.X
X.X....XX.XX.XX
XX..XX....X...X
X..X...XXX..X.X
X.X..XX....X..X
X..XX...XX.X.XX
XX..X.XX..XX..X
X..X...X.X...XX
X.X..X.X.X.X..X
X.X.X....X..X.X
X..X..XX..X.X.X
XX..X..XXXX..XX
X.X...X....X..X
X..X.X..XX...XX
XX..X..X.XXX..X
XXX..X.X....X.X
XXXX...X.X.XX.X
X.XXX.X..X....X
XXXXXXXXXXXXXXX
