XXXXXXXXXXXXXXXXXXXXXXXXXXXXXXXXXXXXXXXXXXXXXXX
X..X.X.........X...X.X....X...........XX..X..eX
XX.....XXXXX.X.X.X.....XX.XXXX.X.X..X...X...X.X
X..X.X.X...X.XXX..X.XX..X.....XX.X...XX..X.X..X
X.X.X.X..X.X....X.X.X.XX.XX.X.X...XX.X.X.X..X.X
X......XX...XXX...X.X....XXX..X.XX.X.X...XX...X
X.XXXX...X.X..XXX.X..X.X..X..XX....X..X.X...X.X
XX...XXX.....X...X.X.X..X..X...XXX..X.X..XX.X.X
X..X....XX.X.X.X...X..X..X..XX.X....X.XX...X..X
X.X.XXX..X..X...XX..X.XX..X.X...X...X...XX...XX
X...X.XX..X.X.XX...X....X.XX..XX...X.XX...XX..X
XXX.X...X..X.X....XX.XX.X....X...X.....XX..XX.X
X....X.X.X.X...XX...XX..X.XXX.X.X.X.XX...X...XX
X.X.X....X...XXX..X.X..XX...X......X...X.XXX..X
X.....XX..XXX....XX.X.X..XX..X.XXX..XX..X...X.X
X..X....X.....XXX...X.X.X..X......X....X..X.X.X
X...X.X..X.X.X..X.XX..X...X.X...X.X.X.X..X..X.X
XXX.X.XXXXXX.X....X..X..X.X.X.XX...X.X..X.X...X
X.X.XX...X...X.X.X..X.X.XX...X.X.XX...X.X..XX.X
Xs.....X...XX......X.......X........X....X....X
XXXXXXXXXXXXXXXXXXXXXXXXXXXXXXXXXXXXXXXXXXXXXXX
