XXXXXXXXXXXXXXXXXXXXXXXXXXXXXXXXXXXX
X..XX.X........XX....X....X.....XXeX
XX....X.XX.XXX....X.X..XX...XXX....X
XXX.X.X..X.X...XXX..X.X.X...X..XX.XX
XX...X..XX..X.X...XX....XXX...XX...X
X..X.X.X..X..XX.X..X.XXX...X.X...X.X
X.X.X..X.X.X.......X.X...X..X...X..X
X.X...XX...XX.XXX..X.X.X..X...X.X.XX
X...XX...X...X...X...X.X.X.X.X....XX
X.X..X.X.X.X.X.X.X.X.X..X..X..X.X..X
XX.X......X..X.X..X.XXX.X.XX.X...XXX
X...X.X.XX..X...X....X..X...X..X...X
X.X.X..X.X.X..X..XXX.X.X.XX...X.XX.X
X.X..X.....X.X.X.X.....X...X.X...X.X
X.XX..X.XX..X..X..X.XX..X.X.X..X...X
X...XXX...X...X.X..X.X.X......X.XX.X
X.X.....XX.XX.X..X.X...X.X.X..X....X
X..XXX.X...X..XX....X.XX.X...X..X.XX
X.X..X.X.X...X.X..X.X.X..XX.X.XXX..X
X...X..X..X.X....XX..X..X..X......XX
XXX.XX.XX.X..X.X...X..X...X..X.XX..X
X....X..X.X.X...XX.X.XX.X..X.X..X.XX
XX.X..X.......XX...X.X...X..X..X...X
Xs..X..X.X.X.X...X.X...X..X...X..X.X
XXXXXXXXXXXXXXXXXXXXXXXXXXXXXXXXXXXX
